#########################
#....###**\...........###
#***.###.\..\.........###
#....................\###
#....###...........\..###
#....###.....*.\...\..###
#.\..###.....\........###
#....###..............###
#..\.###..............###
#....###.################
###.####.################
###.####.################
#.....\*.........\..\.RL#
#....###.####.###########
#.\..###.###....\.\..####
#....###.###.........####
#..\.###.###.........####
#....###\###....\\..\####
#########################

