###########################
#...*.....*.##.##.........#
#...\.... *.##.##...*.....#
#........ ..#*.     .*....#
#........ ..## ##.. .*.*..#
#........ ..## ##.. ...\..#
#...... * ..## ##......\..#
######### #### ############
#........*   * ........\RL#
#....... ...## ############
#...........## #...**....##
#....***....## #...*.....##
#...........## #.. \ ....##
#...........## #*..\...*.##
#...........## #*......\.##
#\..........## #\........##
#............*   .......###
#.......\...##.#..\......##
###########################
