###################################
##\........*.###.##################
##......\..\.###.##\..........\.###
##............\..##..........\..###
##.\.........###.##.............###
##...........###.##.............###
##...........###.##.............###
##..\........###.##.........*...###
################.##.........\...###
################.##.\.\\........###
################.###########.######
################.###########.######
#.\...\..\..........\...........RL#
#######.########.#######.##########
#######.########.....\..\....######
###...........##............\######
###....***....##.........\...######
###.\.........##.........\...######
###...........##...\....\....######
###...........##.............######
###.....\.\...##..\\\........######
###...........##.\.....\.....######
###...........##..\..........######
###...........##.........\...######
###......\....##.............######
###...........##.............######
###....\......##.........\...######
###...........##.\...\.......######
###........\..##.............######
###...........##.##################
###...........##.##################
################.##################
################.##################
################.##################
###################################
