####################################################################################################
#.....\.\\...\*.\.....*..\*\....*...*.*.*\\\........*....\\\*..\.\...\..*...*.*\.\..*..\*.....\.\..#
#############.#######.###.#####.*##.#.#.###########.#######.*##########\###\#\#####.*##.*########..#
#...*..\.\\.\\\\.....\....\\*.\.*.\..\\\.......\....\.*.....*...\..\*.*\......\..\..*.\\*.\.....\\.#
###.*######################.###\*####################.#####.*######\#.*############.###\#########\.#
#\..*.*.*\.\....*.....*\*.*.....*.\...*\.\.......\*.....*\.\*....\.\\.*\..\..\\.\.*......\\........#
###\#.#.*######.#####.#.#.#####\#####.###########\#####.###.#########.###########.###############..#
#..\....*...*..\....\........\..\..\*\......*.*\...\*\......\.\.*\\.*\....*.......\\.......\\...*..#
#######\*##\#######################.#######\#.*####.###########\*##\#####.*####################.#\.#
#.\.*...*....\\.*\*....\*...*...*\*...*\.....\*\..*.\.*\*\\.*.*.*.......*\*....\.\\.\.....\....\...#
###.###\#######.#.#####.*##\*##\#\###\#######.*##.###.*.*##.#.#.#######.#.#######################.\#
#\...\*..\....*....\*..\*.\.*...\\\....\\\....*.*\..*.*.*.*\..\.\\...\*\\\.\\...\\\......\..\.*....#
#####.#######.*####.###.###.#################\#\###\#.*.#.###########.#######################\###..#
#\.....\\.*\\.*...*..\.\.\*\\........\*.......\...*\..*.....\..\*\......\\*.\...*......\.....\.....#
#########.###.###.#######.###########\*##########.###.#########.#########.#####.#################.\#
#\..*\.\.\\\.\...\..\...*\.\....\.....*...*.\\*.\..\*\.\..\....\..\\....*.\\....\...*.*.\..\..*\.\.#
###.###################\#############.###.###.#####.###################.###########\#\#######.###..#
#.*.\..\*...*\.\\\.\........*.*...\.....\...\.\.\.\...\..\..*....\.\*.*.......*...*...\.*\.........#
#.*####.###\###############.#.#############################.*######\#\#######.*##.#####.#########\\#
#.*.*..\........*.*....\*.........*\.\.\\.........\\\.\.\\.\*...........\\*\..*.\..........\..\.*..#
#\#\###########.*.#####.*########.*########################.#############\###.#################.#..#
#\.......\*.*.*\*...*\*.*..\.\...\*\.\*.....*\\..\*..\*\.\*.\.\\..*\....*.\....\..*....\*\..\....\\#
#########.#.*.#.###.*.#.#########.*##.#####\#####\*##.###.#######.#####.#########\#####.#########..#
#.*....\*...*\\.\\\.*...\..\....\.*........\....\.*......\...\\.*\....*\..*..\*.\\.....\...\......\#
#.#####.###.*######\#############.*##############.#############.*####.*##.###.*##################..#
#\..*\..\...*....\..\.\....\.\....*\....\\*.\......\......\..\.\*\\.\.*...\...*\.\*\*\\\..*.*.*.\\.#
###.#######.#####################.#######\#####################\#####\#######.###.#.#####.#.#.###..#
#.\...\..........\....\.\\..\\....\...\.\\.....\\..\...\......\...\.........\.........\.\..\\\..\..#
#R\.\\.\.\.\...\.\........\....\..\\...........\\.\\.\..\.\..\.......\.\\.\....\.....\\.\.\..\.....#
##################################################################################################L#

