###############
#.*\#.\...#...#
#\#\#####\###.#
#.#\.\..#.#.#\#
#.#####.#.#.#\#
#.#\\.#....\..#
#.###.#######\#
#\\\.\*.....\.#
##.##.#### * .#
#.*.#\.\#.#\#.#
#.#\###.#.#.#.#
#.#\\.#...*...#
#.###.###\###.#
#R..\\\.\.\...#
#############L#

