####################################################################################################
#.*\*.*\.....\*...*\*.\\.\*.*.*\..\.*\\..\*...*.*.*.*.*.*\*...*.*...\\*.*.*...*.\\*.*\..*.*.\...*..#
#.#.#.#######.###\#.#####.#.#\#####.#####\###.#.#.#.#.#.#.###.#.#####\#.#\###.###.#\###.#.#####\#..#
#.....\.*\....*\*\\....\*\..*..\*.\.*\*.......*\\\.\*...*.*\.\....\.*\*.\\*.*\.\*\*\*.*...\.*.*\*..#
#######\#####.#.#######.###.###\###\#\#######.#####\###\#.#########.#\###.#.###.#.#.#.#####\#.#\#.\#
#...*..\\.*...\\*.\\.\*.*...*\*.*\*\*.*.*.*.*...*.*...\...*.\.*..\....*.*...\.......*...\..\\..\*..#
###.#####.#####\#####.#.###\#.#.#.#.#.#\#.#\###.#.#######\###.#######.#.###########\###########.#.\#
#.*\..*.*\....*\.\.\...\*...*.*...\.*.*\*...\.*.*.......*.........*.*..\*..\*\.\*..\*.*.*\.\*\..*.\#
#.###.#.#####.#########\###.#\#####.#.#.#####\#.#######\#########.#.###.###.###\###.#.#\###.###.#..#
#..\.\*.*.*.\.*.*.*\*...*\*.*\*.*...*\*\..\\....*.*\*\*\*.....*.*...*.*.\...*\\\*.*\.\\..\.\.\..\.\#
#####.#.#\###.#.#.#.###.#.#\#.#\###\#.#########.#.#.#.#.#####\#\###.#.#####\###.#.###############..#
#.......*.*...*.*\*.*.*.\.*..\*\*\*.*.*.\.*......\*..\....\.\.*.....*.*...\.....*\*\.\*.*.*\..*.*\.#
#######\#.###.#.#.#.#.###\###\#.#\#\#.###\#######.###########\#####.#.#########\#.###\#.#\###.#\#..#
#.*\..*.....*...*\*.\...*..\*....\*.\.*\*.*\..\..\..*\*.*......\..*....\*.*.\.*.*.\\*.\.\.*.\.*.*\.#
#.###.#####.###.#\#####\###.#####.###.#.#.#########.#.#.#########.#####\#\###.#.###.#####.###.#\#\.#
#..\.\..*.\.*.....*.*.*..\*.*.*.*..\*\.....\\.*.*\.\.\*.\\*.*\..\.*.*.......*.*.*...*.\.*.*...*..\.#
#######\###.#####.#.#.###.#.#.#.###.#########.#.#####\###\#.#####\#.#######\#.#\###.###.#.###.###..#
#...\.*.\...*\*...*.*.*.*..\..*..\.\.\..\\..*\*.*\.\*\*\*.\.\.\\*.*.\.\.*\*.*.\.*...*.*\..*........#
#####.#####\#.###.#.#.#.#####\#############\#.#.###.#.#.#######.#\#####.#\#.###.###\#.###\#######..#
#\*.*.\.*\*.*...\.*.....*.*\*.*...\.*.....*.\.*.*...*.......\..\..\.*.*.*.*...*.*\*.....*..\*\*\.\.#
#.#.###\#.#.#####\#####.#.#.#.#####.#####.###.#.###.###############.#.#\#.###.#.#.#####.###.#.###..#
#...*...*..\*.*.*\\\*.*...*...*....\...\\.*...\\*...*\*.*\*.*...*......\*\\.*.\.*.*.\..\..*\*.*.\\.#
###.###.###\#.#.###.#.###.###.###########\#####.###\#\#.#.#.###.#######.###\###.#\#######.#\#.###..#
#.\.\...*.*.*\..*.\...*.*.*.*...*.......\.*\*...*\*..\*.*\...\....*.*.*\*.\.\.\.\..........\*.*.*..#
#######.#.#\###.#####.#.#.#\###.#########.#\###\#.###.#.#########\#.#.#.###################.#\#\#\.#
#..\*.\.*\.\*.*.*.*.*.*\*.\.*..\..*\*.*......\*.*.*.*.*\..*.*.*\*...*.....*\*.\.*.*...*.\.....*.*..#
###.###\###.#.#\#\#.#.#.###.#####\#.#.#######\#.#\#\#\###.#\#\#.###\#####.#.###.#.###\#######.#\#\\#
#.\.\......\.\.\...\.\......\...\....\....\..........\....\.\\..\.....\.\.............\\.....\\\.\\#
#R...........\.\\.\.\...\.\\.......\.\.....\\\\\...\.....\\...\..\..\...\.......\...\.\\..\.....\..#
##################################################################################################L#

