###################
#.*...*.*.......*.#
#.###.#.#######.#.#
#.\..........\...\#
#################.#
#.*.*\\\*.*.....*.#
#.#.###.#.#####.#.#
#\..\.\...*...*.*.#
#########.###.#.#.#
#...*\..*\*...*..\#
###.###.#.###\###\#
#.*...*..\\\*.*.*\#
#\###.#####.#\#.#\#
#..\*...*.\.*.*.*.#
###.###.###.#.#.#\#
#...*.*.*\*\......#
###.#\#.#\#######.#
#R........\......\#
#################L#

