##################*######
#\\.\.\.#...#.#.#.\.#...#
#######.#*#.#.#.###.###.#
#*\.#.#.#.#.#.#.#.....#.#
#*#.#.#.#\#.#.#\#####\#\#
#.#.#\\.#.\.#.#.#\#.#...#
#.#.###.#.#.#.#.#\#\.*#.#
#.#.#.\.#.#...#.#....\\.#
#.#.###.#.###.#.###.###.#
#.#...\\.\....#.#\\..\#\#
#.##########*.#.#.###.#.#
#\#\.\#.#....\#.#\.\#.\.#
#.###.#.#####.#.###.###.#
#\....#.#.....# *\....\.#
#.**#.#.#####.# #######.#
#.\\.\#.#.#.#...#...#\#.#
#####.#.#.#.###.###.#.#.#
#...#.#\..#\....#.#.#.#.#
###.#.###.#####.#.#.#.#.#
#.#........\#..\#.\\#.#.#
#.######***.###.###.#.#.#
#.......#.#...#\..#...#.#
######*\#.#*#.###.###.#.#
#R....\..............\..#
#######################L#

